000000000000000000
031111111111111110
011111111111111110
011111111111111110
011111111111111110
011111111111111110
000000000000000110
022222222222222110
022222222222222110
000000000000000000
