00000000
02112110
01301020
02112110
00000000
