000000000000000000
012211112211112210
010010010010010010
020020020020020020
011110013110011110
002100002100002100
001112111112111100
000000000000000000
