00000000
02112140
01301020
02112010
00000000

