00000000000000000000
01121101000211000000
00001001000101121120
00012111000100001000
00001000012100011000
00211012101000001210
00001110111000011200
00112100001121110110
02101000111010000010
00001012101102100010
00121010000000111120
00001120000011101010
00000011101210002030
00000000000000000000
