00000000
02112110
01301020
02112010
01001000
02121000
00000000
