00000000000
01112111120
01301120000
01112111110
01001000100
02142111200
00000000000
